{
  "case": "case9",
  "buses": {
    "1": { "x": 500, "y": 120 },
    "2": { "x": 120, "y": 780 },
    "3": { "x": 880, "y": 780 },
    "4": { "x": 500, "y": 300 },
    "5": { "x": 260, "y": 430 },
    "6": { "x": 260, "y": 640 },
    "7": { "x": 500, "y": 760 },
    "8": { "x": 740, "y": 640 },
    "9": { "x": 740, "y": 430 }
  }
}
