{
  "case": "case14",
  "buses": {
    "1": { "x": 120, "y": 170 },
    "2": { "x": 290, "y": 180 },
    "3": { "x": 480, "y": 260 },
    "4": { "x": 330, "y": 360 },
    "5": { "x": 150, "y": 360 },
    "6": { "x": 610, "y": 520 },
    "7": { "x": 470, "y": 470 },
    "8": { "x": 470, "y": 650 },
    "9": { "x": 610, "y": 700 },
    "10": { "x": 740, "y": 760 },
    "11": { "x": 730, "y": 560 },
    "12": { "x": 860, "y": 480 },
    "13": { "x": 880, "y": 650 },
    "14": { "x": 760, "y": 900 }
  }
}
