{
  "case": "case30",
  "buses": {
    "1": { "x": 90, "y": 120 },
    "2": { "x": 210, "y": 140 },
    "3": { "x": 330, "y": 150 },
    "4": { "x": 450, "y": 200 },
    "5": { "x": 200, "y": 310 },
    "6": { "x": 470, "y": 350 },
    "7": { "x": 330, "y": 330 },
    "8": { "x": 610, "y": 320 },
    "9": { "x": 550, "y": 500 },
    "10": { "x": 690, "y": 560 },
    "11": { "x": 550, "y": 690 },
    "12": { "x": 360, "y": 560 },
    "13": { "x": 240, "y": 650 },
    "14": { "x": 350, "y": 720 },
    "15": { "x": 500, "y": 740 },
    "16": { "x": 630, "y": 720 },
    "17": { "x": 780, "y": 690 },
    "18": { "x": 850, "y": 820 },
    "19": { "x": 700, "y": 860 },
    "20": { "x": 560, "y": 880 },
    "21": { "x": 760, "y": 470 },
    "22": { "x": 870, "y": 510 },
    "23": { "x": 660, "y": 900 },
    "24": { "x": 830, "y": 900 },
    "25": { "x": 900, "y": 690 },
    "26": { "x": 940, "y": 820 },
    "27": { "x": 910, "y": 360 },
    "28": { "x": 640, "y": 430 },
    "29": { "x": 930, "y": 230 },
    "30": { "x": 820, "y": 160 }
  }
}
